111111
100101
110001
1100W1
111111
